1111111
10P0C01
1000001
1000C01
10000E1
1111111